test
################
#   V          #
#######  #  #  #
#              #
#     $$$      #
#    $   $   ###
#              #
#     $ $    ###
#              #
#    ##  #######
#    #      X  #
########   $$$ #
# X            #
#  $$$     $   #
#      #       #
################
