game
############################################
#        ####   V  ##############        ###
# $    $ ####      #  #  #  #  #   #  #   ##
#  #  #  #     ##                          #
#  #  #  #     ##                          #
#        #  #      #  #  #  #  #   #  #   ##
#  $  $  #  #      ##############        ###
##  ##      ###  #################      ####
##  ##      ###  ##################    #####
#  $  $  ######  ###################  ######
#        #            ##############  ######
#  #  #  #                    ######  ######
# $#  #$ #  ########          ###        ###
#  #  #  #         #  ##  ##  ###        ###
#        #    $  $    #    #  ###  ####   ##
#        #  #         # $$ #       #$$$   ##
###   #  #  ########  #$  $#       #$$$   ##
#$    #  #            ###########  ####   ##
#$    #$$#            #####     #        ###
###  ##########  ########## $ $ #        ###
#    #                    #  #  ####  ######
#    #   $   $    $   $   #  #     #  ######
#  ###                    #    $ $ #  ######
#        ##          ##   #        #  ######
#        ##          ##   ###  #####  ######
#  ###                                     #
#    #    $   $  $   $     $      $      $ #
#  $ #                                     #
#   $#   ##          ##   ##############   #
#  $ #   ##          ##   #      ##        #
#    #                    # $   $  $       #
#  ###   $   $    $   $   #  ##      ###   #
#  ###                    # $   $  $   #   #
#    #   ##          ##   #      ##    #   #
#   $#   ##          ##   ###  #########   #
#  $ #                                     #
#   $#    $   $  $   $    $      $       $ #
#    #                                     #
#  ###   ##  ##  ##  ##   ##################
#  ###   ##  #    #  ##   ##################
#            #    #       ##################
#        $   #    #       ##################
#            #    #       ##################
############################################
