################
#   X          #
#  #  #  #  #  #
#              #
#     $$$      #
#    $   $   ###
#              #
#     $ $    ###
#              #
#    ##  #######
#    #      X  #
########   $$$ #
# V            #
#  $$$     $   #
#      #       #
################
